NO textures/wolfenstein/grey_stone.xpm
SO textures/wolfenstein/purple_stone.xpm
WE textures/wolfenstein/red_brick.xpm
EA textures/wolfenstein/wood.xpm

F 18,53,-25
C 153,204,255



111111111111
100000000011
100000000001
111111110001
1000S0000001
111111111101
110000000001
111111111111